*************
*xxxxx*xxxxx*
*x*********x*
*x*xxx*xxx*x*
*x*x*****x***
*****x*x***x*
*x*x*****x***
*x*xxx*xxx*x*
*x*********x*
*xxxxx*xxxxx*
*************